Date,High,Low,Range,Volatility Threshold,Compression
2025-08-23,23680,23500,180,180,1
2025-08-24,23690,23510,180,180,2
2025-08-25,23650,23520,130,180,3
2025-08-26,23630,23530,100,180,4
2025-08-27,23620,23540,80,180,5
2025-08-28,23610,23550,60,180,6
2025-08-29,23600,23560,40,180,7
2025-08-30,23590,23570,20,180,8
2025-08-31,23580,23580,0,180,9
2025-09-01,23570,23590,-20,180,10
